rel,head-pos,child-pos	tree-label	gold-label
appos,NOUN,PROPN	req-agree	NA
mod,NOUN,ADJ	req-agree	req-agree
appos,NOUN,NOUN	req-agree	NA
comp:aux,AUX,VERB	req-agree	NA
comp:obj,VERB,NOUN	NA	NA
conj,VERB,VERB	req-agree	NA
subj,VERB,NOUN	req-agree	NA
comp:obl,VERB,PRON	NA	NA
subj,VERB,PRON	req-agree	req-agree
det,PRON,DET	req-agree	req-agree
flat@name,PROPN,PROPN	req-agree	req-agree
subj,VERB,PROPN	req-agree	NA
appos,PROPN,NOUN	req-agree	NA
comp:obj,VERB,PRON	req-agree	NA
comp:obj,VERB,VERB	NA	NA
subj,AUX,PRON	req-agree	req-agree
comp:obj,VERB,PROPN	req-agree	NA
mod,NOUN,VERB	req-agree	NA
udep,VERB,PROPN	req-agree	NA
mod,NOUN,NUM	req-agree	NA
flat,NUM,NUM	req-agree	req-agree
mod,NUM,NOUN	req-agree	NA
comp:obl,VERB,PROPN	req-agree	NA
det,NOUN,DET	req-agree	req-agree
mod,PROPN,VERB	req-agree	NA
udep,VERB,NOUN	req-agree	NA
udep,AUX,NOUN	NA	NA
conj,NOUN,NOUN	req-agree	NA
subj,VERB,ADJ	req-agree	req-agree
unk@expl,VERB,PRON	req-agree	NA
comp:aux,AUX,AUX	req-agree	req-agree
comp:obl,VERB,NOUN	NA	NA
udep,NOUN,NOUN	NA	NA
subj,AUX,NOUN	req-agree	NA
subj,AUX,PROPN	req-agree	NA
mod,ADJ,NOUN	req-agree	NA
comp:pred,AUX,ADJ	req-agree	req-agree
mod,PROPN,ADJ	req-agree	req-agree
mod,NOUN,NOUN	req-agree	NA
vocative,VERB,NOUN	NA	NA
appos,PRON,NOUN	req-agree	NA
appos,PRON,PROPN	req-agree	req-agree
appos,PRON,ADJ	req-agree	NA
comp:pred,AUX,PRON	NA	NA
comp:obj,VERB,AUX	NA	NA
vocative,PRON,NOUN	req-agree	req-agree
comp:pred,VERB,NOUN	NA	NA
det,NOUN,PRON	NA	NA
mod,PRON,ADJ	req-agree	req-agree
comp:pred,AUX,NOUN	req-agree	NA
flat,DET,ADJ	req-agree	req-agree
appos,ADJ,PROPN	req-agree	req-agree
subj,AUX,ADJ	req-agree	req-agree
mod,AUX,VERB	req-agree	NA
conj,PROPN,PROPN	req-agree	req-agree
comp:obj,VERB,ADJ	NA	NA
det,ADJ,DET	req-agree	NA
dislocated,VERB,VERB	NA	NA
subj,VERB,VERB	req-agree	NA
flat,ADJ,ADJ	req-agree	req-agree
mod,NOUN,PROPN	req-agree	NA
mod,VERB,AUX	req-agree	NA
mod,VERB,VERB	req-agree	NA
conj,PROPN,NOUN	NA	NA
conj,NOUN,PROPN	NA	NA
conj,PROPN,ADJ	req-agree	NA
conj,VERB,NOUN	NA	NA
conj,AUX,ADJ	NA	req-agree
comp:obj,ADJ,VERB	req-agree	NA
conj,NOUN,ADJ	NA	NA
comp:pred,VERB,VERB	req-agree	NA
udep,AUX,PRON	NA	NA
vocative,VERB,VERB	NA	req-agree
dislocated,NOUN,PROPN	req-agree	req-agree
conj,ADJ,ADJ	req-agree	req-agree
comp:obl@agent,VERB,NOUN	NA	NA
unk,VERB,PRON	NA	NA
comp:pred,AUX,VERB	req-agree	req-agree
subj@pass,AUX,ADJ	req-agree	req-agree
subj,PROPN,PROPN	req-agree	req-agree
udep,AUX,PROPN	NA	req-agree
unk,VERB,PROPN	NA	NA
mod,ADJ,ADJ	NA	NA
subj,NOUN,PRON	req-agree	req-agree
appos,ADJ,NOUN	req-agree	NA
mod,PRON,NOUN	NA	NA
mod,NUM,NUM	req-agree	req-agree
comp:obl,VERB,ADJ	NA	NA
conj,VERB,AUX	NA	NA
unk@expl,AUX,PRON	req-agree	NA
det,PROPN,DET	req-agree	req-agree
orphan,NOUN,PROPN	req-agree	req-agree
comp:obj,NOUN,AUX	req-agree	NA
conj,AUX,VERB	NA	NA
comp:pred,VERB,PROPN	req-agree	NA
comp:pred,VERB,ADJ	req-agree	NA
subj,NOUN,ADJ	NA	NA
appos,VERB,ADJ	NA	NA
subj,PROPN,NOUN	req-agree	req-agree
subj@pass,VERB,NOUN	req-agree	NA
orphan,NOUN,NOUN	NA	NA
flat,NOUN,NOUN	req-agree	req-agree
appos,NOUN,AUX	req-agree	NA
mod,PROPN,AUX	NA	req-agree
mod,PROPN,NOUN	req-agree	req-agree
subj,NOUN,NOUN	req-agree	NA
conj,VERB,ADJ	NA	NA
orphan,ADJ,NOUN	NA	req-agree
udep,VERB,ADJ	NA	NA
udep,VERB,NUM	NA	req-agree
det,NOUN,AUX	req-agree	req-agree
mod,NOUN,AUX	req-agree	NA
comp:obl,AUX,PRON	NA	NA
mod,ADJ,VERB	NA	NA
mod,VERB,ADJ	NA	NA
comp:obl@agent,VERB,ADJ	NA	NA
udep,VERB,PRON	NA	NA
flat,VERB,VERB	NA	req-agree
orphan,ADJ,VERB	req-agree	NA
comp:obl,PROPN,ADJ	req-agree	req-agree
mod,AUX,ADJ	req-agree	NA
flat,PRON,PRON	req-agree	req-agree
comp:pred,AUX,PROPN	req-agree	req-agree
conj,VERB,PROPN	req-agree	NA
comp:obj,PROPN,NOUN	req-agree	req-agree
orphan,PROPN,NOUN	NA	req-agree
udep,ADJ,NOUN	NA	NA
mod,NOUN,PRON	NA	NA
comp:obj,ADJ,NOUN	req-agree	req-agree
comp:pred,VERB,PRON	NA	NA
conj,NUM,NUM	NA	NA
comp:obl,AUX,ADJ	req-agree	NA
orphan,NOUN,ADJ	NA	NA
conj,AUX,NOUN	NA	req-agree
conj,NOUN,VERB	NA	NA
subj,ADJ,NOUN	req-agree	req-agree
udep,AUX,NUM	NA	NA
vocative,ADJ,NOUN	req-agree	NA
orphan,NOUN,VERB	req-agree	NA
comp:pred,VERB,AUX	NA	req-agree
subj,ADJ,PRON	req-agree	req-agree
vocative,AUX,NOUN	req-agree	NA
subj@pass,AUX,NOUN	req-agree	req-agree
vocative,AUX,PROPN	req-agree	req-agree
subj,ADJ,ADJ	req-agree	req-agree
parataxis,VERB,VERB	NA	NA
appos,PRON,NUM	req-agree	NA
unk,VERB,NOUN	NA	req-agree
det,ADJ,PRON	NA	NA
mod,PRON,VERB	req-agree	req-agree
udep,PROPN,NOUN	NA	NA
appos,VERB,PROPN	NA	req-agree
comp:obl,ADJ,PRON	NA	NA
dislocated,VERB,ADJ	NA	req-agree
comp:obl,ADJ,ADJ	req-agree	NA
subj,PRON,PRON	req-agree	req-agree
conj,PRON,PRON	NA	req-agree
comp:obl,ADJ,NOUN	NA	NA
mod,ADJ,PRON	NA	NA
subj,AUX,VERB	req-agree	req-agree
vocative,NOUN,NOUN	req-agree	req-agree
dislocated,AUX,VERB	req-agree	req-agree
udep,ADJ,PRON	NA	NA
comp:obl@agent,VERB,PRON	NA	NA
conj,ADJ,VERB	NA	NA
subj@pass,AUX,VERB	req-agree	req-agree
dislocated,VERB,AUX	NA	req-agree
parataxis,AUX,VERB	req-agree	NA
dislocated,VERB,NOUN	NA	req-agree
appos,NOUN,ADJ	NA	NA
conj,ADJ,NOUN	NA	NA
det,VERB,DET	NA	req-agree
udep,NOUN,PRON	NA	NA
vocative,VERB,PROPN	NA	req-agree
comp:obl,NOUN,PROPN	NA	req-agree
mod,PROPN,NUM	req-agree	req-agree
mod,PROPN,PROPN	req-agree	NA
conj,VERB,PRON	NA	NA
orphan,PRON,NOUN	NA	NA
subj,VERB,NUM	NA	req-agree
dislocated,AUX,AUX	req-agree	req-agree
dislocated,AUX,NOUN	req-agree	req-agree
conj,PRON,NOUN	NA	NA
mod,ADJ,AUX	NA	NA
orphan,NOUN,PRON	NA	NA
conj,AUX,AUX	NA	req-agree
comp:obj,NOUN,NOUN	req-agree	req-agree
vocative,VERB,ADJ	NA	req-agree
subj,NOUN,PROPN	req-agree	req-agree
appos,PROPN,ADJ	req-agree	req-agree
comp:aux,AUX,ADJ	req-agree	req-agree
dislocated,VERB,PROPN	req-agree	req-agree
dislocated,VERB,NUM	NA	req-agree
subj@pass,AUX,NUM	req-agree	req-agree
appos,VERB,NOUN	NA	req-agree
appos,PRON,PRON	NA	req-agree
vocative,PRON,PROPN	req-agree	req-agree
comp:obl,AUX,NOUN	NA	NA
comp:obl@agent,NOUN,NOUN	req-agree	req-agree
comp:obl,VERB,NUM	NA	req-agree
mod,NUM,AUX	req-agree	req-agree
orphan,PRON,PRON	NA	req-agree
appos,NUM,PROPN	req-agree	req-agree
