rel,head-pos,child-pos	tree-label	gold-label
comp:aux,AUX,VERB	req-agree	NA
appos,NOUN,AUX	NA	NA
mod,NOUN,NOUN	req-agree	NA
subj,VERB,NOUN	req-agree	NA
conj,NOUN,NOUN	req-agree	NA
mod,NOUN,ADJ	req-agree	req-agree
comp:obj,VERB,NOUN	req-agree	NA
mod,NOUN,PROPN	NA	NA
unk,NOUN,NOUN	req-agree	NA
subj,VERB,DET	req-agree	NA
mod,NOUN,VERB	NA	NA
det,NOUN,DET	req-agree	req-agree
comp:obj,VERB,VERB	NA	NA
comp:aux@pass,AUX,ADJ	req-agree	NA
subj@pass,AUX,NOUN	NA	NA
subj,AUX,NOUN	req-agree	NA
comp:pred,AUX,ADJ	req-agree	NA
conj,AUX,AUX	NA	NA
comp:obj,VERB,DET	req-agree	NA
mod,DET,AUX	NA	NA
comp:obl@agent,ADJ,NOUN	NA	NA
conj,ADJ,ADJ	req-agree	req-agree
udep,ADJ,NOUN	NA	NA
unk,VERB,NOUN	NA	NA
udep,VERB,NOUN	NA	NA
conj,VERB,VERB	NA	NA
comp:obj,ADJ,NOUN	NA	NA
subj,AUX,ADJ	req-agree	req-agree
subj,VERB,ADJ	req-agree	NA
udep,AUX,NOUN	NA	NA
flat,PROPN,PROPN	req-agree	req-agree
appos,PROPN,NOUN	req-agree	req-agree
mod,NOUN,NUM	NA	req-agree
appos,NOUN,NOUN	req-agree	NA
mod@gov,NOUN,NUM	NA	NA
conj,ADJ,VERB	NA	NA
subj@pass,VERB,NOUN	NA	NA
subj,VERB,PROPN	req-agree	NA
mod,PROPN,PROPN	NA	NA
comp:obl,VERB,NOUN	NA	NA
comp:pred,AUX,NOUN	req-agree	NA
unk,VERB,ADJ	req-agree	NA
comp:pred,NOUN,ADJ	req-agree	NA
subj,VERB,PRON	req-agree	NA
udep,VERB,PRON	NA	NA
comp:pred,AUX,NUM	NA	req-agree
comp:obj,VERB,PRON	req-agree	NA
mod,DET,ADJ	req-agree	req-agree
comp:obj,NOUN,NOUN	req-agree	NA
subj,AUX,DET	req-agree	NA
subj@pass,VERB,NUM	NA	req-agree
appos,NUM,VERB	NA	NA
unk,PROPN,PROPN	NA	NA
udep,ADJ,NUM	NA	NA
mod,NOUN,AUX	NA	NA
conj,NOUN,DET	req-agree	NA
mod,DET,VERB	NA	NA
mod,PROPN,ADJ	req-agree	req-agree
comp:pred,AUX,DET	req-agree	NA
comp:obl,VERB,DET	req-agree	NA
appos,DET,NOUN	NA	req-agree
flat,NOUN,PROPN	req-agree	req-agree
conj,DET,ADJ	req-agree	req-agree
udep,VERB,DET	req-agree	NA
conj,PROPN,PROPN	NA	NA
comp:obj,VERB,PROPN	req-agree	NA
conj,AUX,VERB	NA	NA
mod,NUM,NOUN	NA	NA
comp:obj,ADJ,PRON	NA	NA
mod,NOUN,DET	req-agree	NA
subj,AUX,PRON	req-agree	req-agree
parataxis,VERB,VERB	NA	NA
subj@pass,VERB,DET	req-agree	req-agree
mod,VERB,VERB	NA	NA
appos,VERB,VERB	NA	NA
subj@pass,VERB,VERB	NA	NA
comp:obj,VERB,AUX	NA	NA
orphan,NOUN,NOUN	NA	NA
conj,VERB,AUX	NA	NA
mod,ADJ,VERB	NA	NA
comp:obj,VERB,NUM	NA	NA
compound,NUM,NUM	NA	NA
conj,PROPN,NOUN	NA	NA
conj,VERB,NOUN	NA	NA
comp:pred,VERB,ADJ	req-agree	NA
orphan,NOUN,VERB	NA	NA
subj@pass,AUX,DET	req-agree	NA
appos,NOUN,PROPN	NA	NA
det,ADJ,DET	req-agree	req-agree
comp:obl@agent,VERB,NOUN	NA	NA
unk,PROPN,NOUN	req-agree	NA
discourse,AUX,DET	req-agree	NA
comp:obl,VERB,PRON	NA	NA
mod,PROPN,NOUN	req-agree	NA
subj,NOUN,NOUN	req-agree	NA
mod,PROPN,AUX	NA	NA
unk,NOUN,ADJ	req-agree	NA
conj,NOUN,PROPN	NA	NA
conj,NUM,NUM	NA	NA
subj,AUX,PROPN	req-agree	NA
appos,NOUN,DET	NA	NA
udep,AUX,DET	req-agree	NA
udep,NOUN,NOUN	NA	NA
comp:pred,VERB,DET	req-agree	req-agree
udep,VERB,PROPN	NA	req-agree
conj,VERB,DET	req-agree	req-agree
orphan,DET,NOUN	NA	NA
appos,NOUN,VERB	NA	NA
conj,NOUN,AUX	NA	NA
comp:aux,AUX,ADJ	req-agree	req-agree
orphan,ADJ,ADJ	req-agree	req-agree
unk,DET,ADJ	req-agree	NA
conj,NOUN,PRON	NA	NA
comp:obl@agent,VERB,PRON	NA	req-agree
mod,NOUN,PRON	NA	NA
comp:pred,PRON,DET	req-agree	NA
conj,PROPN,ADJ	NA	NA
vocative,VERB,NOUN	NA	NA
conj,NOUN,NUM	NA	NA
comp:obj,ADJ,DET	NA	NA
comp:obj,VERB,ADJ	req-agree	NA
parataxis,VERB,AUX	NA	NA
comp:obl,VERB,ADJ	req-agree	NA
conj,NOUN,VERB	NA	NA
conj,NOUN,ADJ	req-agree	NA
unk@fixed,DET,VERB	NA	req-agree
conj,ADJ,NOUN	NA	NA
conj,AUX,NOUN	NA	NA
conj,VERB,ADJ	req-agree	NA
orphan,ADJ,NOUN	NA	NA
udep,ADJ,PRON	NA	NA
mod,NUM,NUM	NA	req-agree
subj,VERB,NUM	req-agree	NA
subj,VERB,VERB	req-agree	req-agree
mod,PRON,AUX	NA	req-agree
comp:pred,NOUN,DET	req-agree	req-agree
conj,DET,VERB	NA	req-agree
subj,AUX,NUM	req-agree	NA
orphan,PRON,PROPN	NA	req-agree
orphan,PRON,AUX	NA	NA
parataxis,AUX,VERB	NA	NA
conj,PROPN,AUX	NA	NA
det,DET,DET	req-agree	req-agree
unk,NOUN,PROPN	NA	NA
mod,NUM,ADJ	req-agree	NA
mod,ADJ,NOUN	NA	NA
comp:pred,VERB,NOUN	req-agree	req-agree
conj,DET,DET	req-agree	NA
subj@pass,VERB,PROPN	NA	req-agree
orphan,PROPN,PROPN	NA	req-agree
comp:obj,ADJ,PROPN	NA	NA
comp:obl,VERB,PROPN	NA	NA
mod,PROPN,VERB	NA	NA
mod,NUM,VERB	NA	NA
flat,PROPN,ADJ	req-agree	req-agree
comp:aux,AUX,AUX	req-agree	NA
discourse,VERB,PRON	NA	req-agree
udep,VERB,ADJ	req-agree	NA
parataxis,NOUN,VERB	NA	NA
subj,AUX,VERB	NA	NA
conj,AUX,PROPN	NA	NA
subj,VERB,AUX	req-agree	NA
comp:pred,AUX,PROPN	NA	req-agree
mod,NUM,DET	NA	NA
mod,VERB,NOUN	NA	NA
comp:obj,NOUN,ADJ	req-agree	req-agree
udep,AUX,ADJ	req-agree	NA
subj,AUX,AUX	req-agree	NA
subj@pass,AUX,NUM	NA	NA
subj@pass,ADJ,NOUN	NA	NA
unk,VERB,PRON	NA	NA
udep,VERB,VERB	NA	req-agree
unk,NOUN,AUX	NA	NA
unk,VERB,DET	NA	NA
unk,VERB,AUX	NA	NA
unk,NOUN,DET	req-agree	NA
unk,DET,NOUN	NA	req-agree
udep,ADJ,DET	NA	NA
unk,ADJ,DET	NA	req-agree
unk,ADJ,VERB	NA	NA
unk,PROPN,AUX	NA	req-agree
udep,AUX,AUX	NA	req-agree
conj,AUX,DET	NA	req-agree
udep,AUX,PRON	NA	req-agree
unk,PROPN,VERB	NA	NA
conj,AUX,ADJ	req-agree	NA
mod,PRON,VERB	NA	NA
mod@gov,PRON,NUM	NA	NA
subj,ADJ,NOUN	req-agree	NA
udep,ADJ,ADJ	req-agree	req-agree
appos,PROPN,NUM	NA	req-agree
comp:obj,NOUN,PROPN	req-agree	req-agree
comp:pred,NUM,ADJ	req-agree	req-agree
mod,VERB,ADJ	NA	req-agree
appos,ADJ,ADJ	req-agree	req-agree
mod,VERB,AUX	NA	NA
comp:pred,AUX,PRON	NA	NA
conj,PRON,NOUN	NA	NA
discourse,AUX,PRON	NA	req-agree
det,PROPN,DET	req-agree	req-agree
parataxis,AUX,AUX	NA	NA
vocative,VERB,PROPN	NA	NA
flat@foreign,PROPN,PROPN	NA	req-agree
appos,NUM,NOUN	NA	NA
appos,PROPN,AUX	NA	NA
appos,PROPN,VERB	NA	NA
conj,AUX,NUM	NA	req-agree
orphan,NUM,NOUN	NA	req-agree
orphan,NUM,NUM	NA	req-agree
conj,NUM,NOUN	NA	NA
appos,ADJ,AUX	NA	NA
mod,AUX,AUX	NA	NA
udep,NOUN,NUM	NA	NA
unk,ADJ,NOUN	NA	NA
appos,VERB,AUX	NA	NA
comp:pred,PRON,ADJ	req-agree	req-agree
orphan,NOUN,NUM	NA	req-agree
mod,ADJ,PROPN	NA	req-agree
subj@pass,AUX,PROPN	NA	NA
mod,NUM,PROPN	NA	req-agree
udep,VERB,NUM	NA	NA
unk,PROPN,NUM	NA	NA
orphan,PROPN,NOUN	NA	NA
comp:pred,PROPN,ADJ	req-agree	req-agree
unk,NOUN,VERB	NA	NA
flat,NOUN,NOUN	req-agree	req-agree
orphan,DET,ADJ	req-agree	NA
unk,VERB,PROPN	NA	NA
conj,VERB,NUM	NA	req-agree
unk,ADJ,ADJ	req-agree	NA
unk,VERB,VERB	NA	NA
flat,NOUN,ADJ	req-agree	req-agree
conj,ADJ,DET	req-agree	NA
orphan,NOUN,ADJ	NA	NA
unk,NUM,ADJ	req-agree	NA
unk,DET,DET	NA	req-agree
comp:pred,DET,DET	req-agree	req-agree
unk,VERB,NUM	NA	NA
comp:obj,ADJ,ADJ	req-agree	req-agree
appos,NOUN,ADJ	req-agree	NA
unk,NOUN,NUM	NA	req-agree
mod,NUM,AUX	NA	req-agree
flat,ADJ,PROPN	req-agree	req-agree
udep,PROPN,NOUN	req-agree	req-agree
udep,ADJ,PROPN	NA	NA
conj,PROPN,PRON	NA	req-agree
appos,VERB,PROPN	NA	NA
unk,ADJ,PROPN	NA	NA
udep,VERB,AUX	NA	NA
comp:obl@agent,ADJ,ADJ	req-agree	req-agree
appos,ADJ,VERB	NA	NA
orphan,VERB,VERB	NA	NA
subj@pass,AUX,VERB	NA	NA
subj@pass,VERB,PRON	NA	NA
comp:pred,NOUN,VERB	NA	req-agree
appos,NOUN,NUM	NA	req-agree
subj@pass,VERB,AUX	NA	NA
subj@pass,AUX,ADJ	req-agree	req-agree
mod,PROPN,PRON	NA	req-agree
appos,ADJ,PROPN	NA	req-agree
orphan,PRON,NOUN	NA	NA
orphan,PRON,ADJ	req-agree	NA
mod,PRON,ADJ	req-agree	req-agree
discourse,NOUN,DET	req-agree	req-agree
orphan,DET,VERB	NA	NA
comp:pred,DET,ADJ	req-agree	NA
mod,ADJ,NUM	NA	NA
mod,AUX,VERB	NA	NA
comp:pred,PROPN,DET	req-agree	req-agree
mod,NUM,PRON	NA	req-agree
comp:pred,ADJ,ADJ	req-agree	req-agree
udep,AUX,PROPN	NA	req-agree
udep,PROPN,PROPN	NA	req-agree
orphan,VERB,AUX	NA	NA
mod,ADJ,AUX	NA	req-agree
vocative,AUX,ADJ	req-agree	NA
discourse,VERB,DET	NA	NA
comp:obl@agent,ADJ,PROPN	NA	req-agree
conj,PROPN,VERB	NA	NA
flat,PROPN,NOUN	req-agree	req-agree
conj,VERB,PROPN	NA	req-agree
subj,PROPN,PROPN	req-agree	req-agree
orphan,PROPN,NUM	NA	req-agree
comp:aux@pass,AUX,AUX	NA	NA
appos,PRON,NOUN	NA	NA
mod,PROPN,NUM	NA	req-agree
orphan,NOUN,PROPN	NA	NA
conj,NUM,ADJ	NA	NA
comp:pred,PROPN,NOUN	req-agree	req-agree
orphan,NOUN,DET	NA	req-agree
comp:obj,NOUN,DET	NA	req-agree
conj,PROPN,DET	req-agree	NA
appos,PROPN,DET	NA	NA
unk,ADJ,NUM	NA	req-agree
parataxis,NOUN,AUX	NA	req-agree
mod,ADJ,ADJ	req-agree	req-agree
udep,NOUN,ADJ	req-agree	req-agree
orphan,NUM,VERB	NA	NA
parataxis,PROPN,VERB	NA	NA
appos,ADJ,NOUN	NA	NA
unk,NOUN,PRON	NA	NA
appos,DET,ADJ	req-agree	req-agree
conj,VERB,PRON	NA	req-agree
orphan,PRON,DET	NA	NA
comp:pred,ADJ,DET	req-agree	req-agree
conj,ADJ,AUX	NA	NA
orphan,ADJ,PROPN	NA	req-agree
parataxis,ADJ,VERB	NA	NA
comp:pred,PROPN,PRON	NA	req-agree
mod,DET,DET	NA	NA
appos,ADJ,DET	NA	req-agree
conj,NUM,VERB	NA	NA
comp:pred,NOUN,NOUN	req-agree	req-agree
appos,DET,VERB	NA	NA
unk,DET,PRON	NA	NA
mod,PRON,PROPN	NA	req-agree
orphan,PROPN,AUX	NA	NA
det,PRON,DET	req-agree	req-agree
orphan,ADJ,VERB	NA	req-agree
comp:obj,ADJ,NUM	NA	req-agree
unk,PROPN,ADJ	req-agree	NA
conj,ADJ,PROPN	NA	req-agree
comp:obl,VERB,NUM	NA	NA
udep,AUX,VERB	NA	req-agree
udep,NOUN,PROPN	NA	req-agree
appos,NOUN,PRON	NA	req-agree
conj,PRON,PROPN	NA	NA
mod,DET,NUM	NA	req-agree
det,VERB,DET	req-agree	req-agree
comp:obj,PROPN,AUX	NA	req-agree
parataxis,PROPN,NOUN	NA	req-agree
parataxis,NOUN,NOUN	NA	NA
appos,NUM,PROPN	NA	req-agree
subj@pass,AUX,PRON	NA	NA
orphan,NUM,ADJ	NA	req-agree
unk,DET,NUM	NA	req-agree
mod,PRON,DET	req-agree	req-agree
flat@foreign,NOUN,ADJ	req-agree	req-agree
flat@foreign,NOUN,NOUN	NA	req-agree
appos,DET,DET	NA	req-agree
comp:obj,ADJ,VERB	NA	NA
conj,DET,AUX	NA	req-agree
appos,PRON,PRON	NA	req-agree
unk,PRON,DET	req-agree	req-agree
comp:pred,PRON,PRON	NA	req-agree
orphan,DET,NUM	NA	NA
comp:obl@agent,ADJ,DET	NA	req-agree
parataxis,PROPN,AUX	NA	req-agree
appos,VERB,DET	NA	req-agree
unk@fixed,DET,AUX	NA	req-agree
udep,AUX,NUM	NA	NA
comp:obl@agent,ADJ,PRON	NA	req-agree
