rel,head-pos,child-pos	tree-label	gold-label
subj,AUX,PRON	req-agree	req-agree
comp:pred,AUX,NOUN	req-agree	req-agree
conj,AUX,VERB	req-agree	NA
det,NOUN,PRON	req-agree	req-agree
subj,VERB,NOUN	req-agree	req-agree
subj,VERB,PRON	req-agree	req-agree
mod,NOUN,ADJ	req-agree	req-agree
conj,ADJ,PRON	NA	NA
comp:obj,VERB,NOUN	NA	NA
mod@relcl,NOUN,VERB	req-agree	NA
comp:obl,VERB,ADJ	NA	NA
mod,ADJ,PRON	NA	NA
comp:obj,VERB,ADJ	NA	NA
conj,VERB,VERB	req-agree	req-agree
udep,ADJ,PRON	NA	NA
comp:pred,AUX,ADJ	req-agree	req-agree
mod,NOUN,PRON	req-agree	NA
comp:aux@pass,AUX,VERB	req-agree	req-agree
mod@relcl,NOUN,AUX	req-agree	NA
comp:pred,AUX,PRON	req-agree	NA
subj,VERB,PROPN	req-agree	req-agree
comp:obj,VERB,PRON	req-agree	NA
subj@pass,VERB,NOUN	req-agree	req-agree
mod,NOUN,VERB	req-agree	NA
mod,NOUN,NOUN	NA	NA
subj,VERB,NUM	req-agree	req-agree
subj@pass,VERB,PRON	req-agree	req-agree
mod,VERB,VERB	req-agree	NA
subj,AUX,NOUN	req-agree	req-agree
udep,VERB,PRON	req-agree	NA
det,PROPN,PRON	NA	req-agree
mod,PRON,PROPN	NA	req-agree
conj,AUX,AUX	NA	req-agree
mod,PRON,NOUN	NA	NA
comp:pred,VERB,ADJ	req-agree	req-agree
conj,NOUN,NOUN	NA	NA
mod@relcl,ADJ,AUX	req-agree	NA
comp:pred,AUX,VERB	req-agree	req-agree
mod,PRON,ADJ	req-agree	req-agree
comp:pred,AUX,NUM	req-agree	NA
udep,NUM,NOUN	NA	req-agree
subj,AUX,PROPN	req-agree	req-agree
comp:obj,NUM,PRON	NA	req-agree
det,PRON,PRON	NA	req-agree
udep,VERB,NOUN	NA	NA
conj,NOUN,VERB	req-agree	NA
conj,VERB,NOUN	NA	NA
mod,NOUN,PROPN	req-agree	req-agree
mod@relcl,PRON,VERB	req-agree	NA
conj,NUM,PRON	NA	req-agree
mod,AUX,AUX	NA	req-agree
subj,AUX,ADJ	req-agree	req-agree
mod,ADJ,ADJ	req-agree	NA
subj,VERB,ADJ	req-agree	NA
comp:pred,AUX,PROPN	req-agree	req-agree
mod,ADJ,PROPN	NA	NA
mod,VERB,PROPN	req-agree	req-agree
subj@pass,AUX,NOUN	req-agree	NA
comp:obj,PRON,VERB	NA	req-agree
subj,AUX,VERB	req-agree	req-agree
mod,NOUN,NUM	req-agree	req-agree
comp:pred,VERB,VERB	req-agree	NA
conj,PRON,PRON	NA	NA
comp:pred,VERB,NOUN	req-agree	NA
mod,PRON,PRON	NA	NA
mod,VERB,ADJ	req-agree	req-agree
subj@pass,AUX,PRON	req-agree	req-agree
conj,AUX,ADJ	NA	req-agree
udep,AUX,PROPN	NA	req-agree
mod@relcl,PRON,AUX	req-agree	NA
comp:obj,NOUN,PRON	NA	NA
subj@pass,VERB,VERB	req-agree	req-agree
subj,VERB,VERB	req-agree	req-agree
comp:obj,VERB,PROPN	NA	NA
comp:obj,VERB,VERB	NA	NA
orphan,VERB,NOUN	NA	NA
det,VERB,PRON	req-agree	req-agree
subj@pass,VERB,PROPN	req-agree	req-agree
conj,PROPN,NOUN	NA	NA
conj,PRON,NOUN	NA	NA
mod@relcl,VERB,VERB	req-agree	NA
conj,ADJ,ADJ	req-agree	req-agree
mod,ADJ,NOUN	NA	NA
appos,PRON,NOUN	NA	req-agree
comp:obj,ADJ,PRON	NA	req-agree
conj,NOUN,PRON	req-agree	NA
mod,PRON,VERB	req-agree	NA
conj,VERB,AUX	req-agree	NA
conj,ADJ,VERB	req-agree	NA
udep,AUX,NOUN	NA	NA
udep,AUX,PRON	NA	NA
subj@pass,AUX,ADJ	req-agree	req-agree
subj@pass,VERB,ADJ	req-agree	req-agree
subj@pass,VERB,NUM	req-agree	req-agree
orphan,NOUN,NOUN	NA	NA
mod,ADJ,VERB	req-agree	NA
mod@advmod,PRON,NOUN	NA	req-agree
mod@advmod,NOUN,VERB	req-agree	req-agree
comp:obl,VERB,PRON	NA	NA
mod,VERB,AUX	NA	req-agree
mod,PROPN,VERB	req-agree	req-agree
conj,PROPN,PRON	NA	NA
conj,NUM,ADJ	req-agree	req-agree
det,ADJ,PRON	NA	req-agree
subj,AUX,NUM	req-agree	req-agree
mod@advmod,NOUN,NOUN	NA	req-agree
subj@pass,AUX,VERB	req-agree	req-agree
comp@pass,VERB,PRON	req-agree	req-agree
mod,NUM,PRON	NA	NA
mod@advmod,NOUN,PRON	req-agree	req-agree
conj,ADJ,NOUN	NA	req-agree
mod@relcl,ADJ,VERB	req-agree	NA
comp:obj,VERB,NUM	NA	req-agree
conj,AUX,NOUN	NA	req-agree
comp:obl,VERB,NOUN	NA	NA
parataxis,VERB,VERB	NA	req-agree
comp:pred,ADJ,VERB	req-agree	req-agree
mod,NUM,VERB	req-agree	req-agree
mod@relcl,VERB,AUX	req-agree	req-agree
subj@pass,VERB,AUX	req-agree	req-agree
comp:obj,VERB,AUX	NA	req-agree
conj,PRON,ADJ	req-agree	req-agree
mod,AUX,VERB	req-agree	NA
conj,VERB,ADJ	req-agree	req-agree
mod@advmod,NOUN,ADJ	req-agree	req-agree
conj,ADJ,AUX	NA	req-agree
orphan,PRON,NOUN	NA	req-agree
subj,NOUN,VERB	req-agree	req-agree
udep,NOUN,PRON	req-agree	req-agree
udep,VERB,ADJ	req-agree	NA
mod,VERB,PRON	req-agree	NA
appos,NOUN,NOUN	NA	NA
comp:pred,VERB,PROPN	NA	req-agree
udep,AUX,ADJ	NA	req-agree
orphan,PRON,PRON	NA	req-agree
conj,NOUN,ADJ	req-agree	req-agree
parataxis,NOUN,VERB	req-agree	req-agree
udep,ADJ,NOUN	NA	NA
flat,NOUN,PROPN	req-agree	req-agree
subj,NOUN,ADJ	req-agree	req-agree
subj,VERB,AUX	req-agree	req-agree
mod@advmod,PRON,VERB	req-agree	req-agree
parataxis,PRON,AUX	NA	req-agree
udep,NOUN,NOUN	NA	NA
det,NUM,PRON	NA	req-agree
mod@relcl,PROPN,AUX	req-agree	req-agree
mod@relcl,NUM,AUX	req-agree	req-agree
mod@advmod,ADJ,NUM	NA	NA
mod@advmod,ADJ,VERB	req-agree	req-agree
mod@advmod,ADJ,ADJ	req-agree	req-agree
mod@relcl,PROPN,VERB	req-agree	req-agree
mod@advmod,PRON,ADJ	req-agree	req-agree
subj,AUX,AUX	req-agree	NA
parataxis,VERB,AUX	NA	NA
udep,PRON,NOUN	NA	req-agree
mod,PRON,AUX	NA	req-agree
mod,VERB,NOUN	NA	req-agree
parataxis,AUX,VERB	NA	NA
conj,PRON,AUX	NA	req-agree
mod,PRON,NUM	NA	req-agree
udep,NOUN,ADJ	req-agree	NA
parataxis,NOUN,AUX	req-agree	req-agree
mod@appos,ADJ,NOUN	NA	req-agree
mod,NOUN,AUX	req-agree	req-agree
udep,NOUN,PROPN	req-agree	req-agree
comp:aux,AUX,ADJ	req-agree	req-agree
mod@advmod,PROPN,VERB	req-agree	req-agree
comp:obj,ADJ,VERB	NA	req-agree
udep,VERB,PROPN	NA	req-agree
comp:obl,VERB,PROPN	NA	NA
mod@appos,ADJ,ADJ	req-agree	req-agree
vocative,AUX,NOUN	NA	NA
comp:obj,NOUN,VERB	NA	req-agree
mod,PROPN,ADJ	req-agree	req-agree
comp:pred,VERB,PRON	NA	req-agree
